20 20
...#....############
##.####......#.....#
.#.#.........#.....#
.#...#....####.....#
.#####.......#.....#
........#....#.....#
#.......#....#.#####
#########..........#
#.......#....#####.#
#.......####.......#
#######............#
#...........########
#...................
######.............#
#..................#
#..................#
######..########...#
#..............#...#
#..............#...#
####################
16 17

